a student helped A student.	A student	a student
a artist painted A artist.	A artist	a artist
a chef cooked A chef.	A chef	a chef
a dancer impressed A dancer.	A dancer	a dancer
a writer inspired A writer.	A writer	a writer
a athlete trained A athlete.	A athlete	a athlete
a musician composed A musician.	A musician	a musician
a doctor treated A doctor.	A doctor	a doctor
a scientist discovered A scientist.	A scientist	a scientist
a driver drove A driver.	A driver	a driver
a teacher educated A teacher.	A teacher	a teacher
a gardener planted A gardener.	A gardener	a gardener
a engineer designed A engineer.	A engineer	a engineer
a actor performed A actor.	A actor	a actor
a photographer captured A photographer.	A photographer	a photographer
a librarian organized A librarian.	A librarian	a librarian
a banker invested A banker.	A banker	a banker
a tailor sewed A tailor.	A tailor	a tailor
a pilot flew A pilot.	A pilot	a pilot
a lawyer defended A lawyer.	A lawyer	a lawyer
a architect designed A architect.	A architect	a architect
a chef cooked A chef.	A chef	a chef
a nurse cared for A nurse.	A nurse	a nurse
a farmer harvested A farmer.	A farmer	a farmer
a plumber fixed A plumber.	A plumber	a plumber
a cashier counted A cashier.	A cashier	a cashier
a painter painted A painter.	A painter	a painter
a therapist counseled A therapist.	A therapist	a therapist
a singer sang to A singer.	A singer	a singer
a firefighter rescued A firefighter.	A firefighter	a firefighter
a fisherman caught A fisherman.	A fisherman	a fisherman
a bartender served A bartender.	A bartender	a bartender
a waiter served A waiter.	A waiter	a waiter
a cashier counted A cashier.	A cashier	a cashier
a receptionist greeted A receptionist.	A receptionist	a receptionist
a athlete trained A athlete.	A athlete	a athlete
a journalist reported on A journalist.	A journalist	a journalist
a soldier fought A soldier.	A soldier	a soldier
a scientist researched A scientist.	A scientist	a scientist
a musician played for A musician.	A musician	a musician
a dancer danced for A dancer.	A dancer	a dancer
a explorer discovered A explorer.	A explorer	a explorer
a manager managed A manager.	A manager	a manager
a coach trained A coach.	A coach	a coach
a cleaner cleaned A cleaner.	A cleaner	a cleaner
a politician campaigned for A politician.	A politician	a politician
a driver drove A driver.	A driver	a driver
a gamer played against A gamer.	A gamer	a gamer
a analyst analyzed A analyst.	A analyst	a analyst
a CEO led A CEO.	A CEO	a CEO
a receptionist greeted A receptionist.	A receptionist	a receptionist
a librarian organized A librarian.	A librarian	a librarian
a programmer coded for A programmer.	A programmer	a programmer
a mentor mentored A mentor.	A mentor	a mentor
a consultant advised A consultant.	A consultant	a consultant
a editor edited A editor.	A editor	a editor
a model posed for A model.	A model	a model
a influencer influenced A influencer.	A influencer	a influencer
a officer patrolled A officer.	A officer	a officer
a coach coached A coach.	A coach	a coach
a cleaner cleaned A cleaner.	A cleaner	a cleaner
a artist created for A artist.	A artist	a artist
a designer designed for A designer.	A designer	a designer
a stylist styled A stylist.	A stylist	a stylist
a banker invested A banker.	A banker	a banker
a cashier counted A cashier.	A cashier	a cashier
a clerk assisted A clerk.	A clerk	a clerk
a director directed A director.	A director	a director
a producer produced for A producer.	A producer	a producer
a writer wrote for A writer.	A writer	a writer
a journalist reported on A journalist.	A journalist	a journalist
a critic critiqued A critic.	A critic	a critic
a developer developed for A developer.	A developer	a developer
a entrepreneur founded A entrepreneur.	A entrepreneur	a entrepreneur
a host hosted A host.	A host	a host
a CEO led A CEO.	A CEO	a CEO
a manager managed A manager.	A manager	a manager
a salesperson sold to A salesperson.	A salesperson	a salesperson
a marketer marketed for A marketer.	A marketer	a marketer
a intern interned for A intern.	A intern	a intern
a analyst analyzed A analyst.	A analyst	a analyst
a researcher researched A researcher.	A researcher	a researcher
a scientist researched A scientist.	A scientist	a scientist
a professor taught A professor.	A professor	a professor
a student studied A student.	A student	a student
a doctor treated A doctor.	A doctor	a doctor
a nurse cared for A nurse.	A nurse	a nurse
a therapist counseled A therapist.	A therapist	a therapist
a patient consulted A patient.	A patient	a patient
a therapist counseled A therapist.	A therapist	a therapist
a patient consulted A patient.	A patient	a patient
a client consulted A client.	A client	a client
a attorney represented A attorney.	A attorney	a attorney
a defendant defended A defendant.	A defendant	a defendant
a judge judged A judge.	A judge	a judge
a witness testified for A witness.	A witness	a witness
a researcher researched A researcher.	A researcher	a researcher
a participant participated for A participant.	A participant	a participant
a volunteer volunteered for A volunteer.	A volunteer	a volunteer
a donor donated to A donor.	A donor	a donor
