a student helped the student.	the student	a student
a artist painted the artist.	the artist	a artist
a chef cooked the chef.	the chef	a chef
a dancer impressed the dancer.	the dancer	a dancer
a writer inspired the writer.	the writer	a writer
a athlete trained the athlete.	the athlete	a athlete
a musician composed the musician.	the musician	a musician
a doctor treated the doctor.	the doctor	a doctor
a scientist discovered the scientist.	the scientist	a scientist
a driver drove the driver.	the driver	a driver
a teacher educated the teacher.	the teacher	a teacher
a gardener planted the gardener.	the gardener	a gardener
a engineer designed the engineer.	the engineer	a engineer
a actor performed the actor.	the actor	a actor
a photographer captured the photographer.	the photographer	a photographer
a librarian organized the librarian.	the librarian	a librarian
a banker invested the banker.	the banker	a banker
a tailor sewed the tailor.	the tailor	a tailor
a pilot flew the pilot.	the pilot	a pilot
a lawyer defended the lawyer.	the lawyer	a lawyer
a architect designed the architect.	the architect	a architect
a chef cooked the chef.	the chef	a chef
a nurse cared for the nurse.	the nurse	a nurse
a farmer harvested the farmer.	the farmer	a farmer
a plumber fixed the plumber.	the plumber	a plumber
a cashier counted the cashier.	the cashier	a cashier
a painter painted the painter.	the painter	a painter
a therapist counseled the therapist.	the therapist	a therapist
a singer sang to the singer.	the singer	a singer
a firefighter rescued the firefighter.	the firefighter	a firefighter
a fisherman caught the fisherman.	the fisherman	a fisherman
a bartender served the bartender.	the bartender	a bartender
a waiter served the waiter.	the waiter	a waiter
a cashier counted the cashier.	the cashier	a cashier
a receptionist greeted the receptionist.	the receptionist	a receptionist
a athlete trained the athlete.	the athlete	a athlete
a journalist reported on the journalist.	the journalist	a journalist
a soldier fought the soldier.	the soldier	a soldier
a scientist researched the scientist.	the scientist	a scientist
a musician played for the musician.	the musician	a musician
a dancer danced for the dancer.	the dancer	a dancer
a explorer discovered the explorer.	the explorer	a explorer
a manager managed the manager.	the manager	a manager
a coach trained the coach.	the coach	a coach
a cleaner cleaned the cleaner.	the cleaner	a cleaner
a politician campaigned for the politician.	the politician	a politician
a driver drove the driver.	the driver	a driver
a gamer played against the gamer.	the gamer	a gamer
a analyst analyzed the analyst.	the analyst	a analyst
a CEO led the CEO.	the CEO	a CEO
a receptionist greeted the receptionist.	the receptionist	a receptionist
a librarian organized the librarian.	the librarian	a librarian
a programmer coded for the programmer.	the programmer	a programmer
a mentor mentored the mentor.	the mentor	a mentor
a consultant advised the consultant.	the consultant	a consultant
a editor edited the editor.	the editor	a editor
a model posed for the model.	the model	a model
a influencer influenced the influencer.	the influencer	a influencer
a officer patrolled the officer.	the officer	a officer
a coach coached the coach.	the coach	a coach
a cleaner cleaned the cleaner.	the cleaner	a cleaner
a artist created for the artist.	the artist	a artist
a designer designed for the designer.	the designer	a designer
a stylist styled the stylist.	the stylist	a stylist
a banker invested the banker.	the banker	a banker
a cashier counted the cashier.	the cashier	a cashier
a clerk assisted the clerk.	the clerk	a clerk
a director directed the director.	the director	a director
a producer produced for the producer.	the producer	a producer
a writer wrote for the writer.	the writer	a writer
a journalist reported on the journalist.	the journalist	a journalist
a critic critiqued the critic.	the critic	a critic
a developer developed for the developer.	the developer	a developer
a entrepreneur founded the entrepreneur.	the entrepreneur	a entrepreneur
a host hosted the host.	the host	a host
a CEO led the CEO.	the CEO	a CEO
a manager managed the manager.	the manager	a manager
a salesperson sold to the salesperson.	the salesperson	a salesperson
a marketer marketed for the marketer.	the marketer	a marketer
a intern interned for the intern.	the intern	a intern
a analyst analyzed the analyst.	the analyst	a analyst
a researcher researched the researcher.	the researcher	a researcher
a scientist researched the scientist.	the scientist	a scientist
a professor taught the professor.	the professor	a professor
a student studied the student.	the student	a student
a doctor treated the doctor.	the doctor	a doctor
a nurse cared for the nurse.	the nurse	a nurse
a therapist counseled the therapist.	the therapist	a therapist
a patient consulted the patient.	the patient	a patient
a therapist counseled the therapist.	the therapist	a therapist
a patient consulted the patient.	the patient	a patient
a client consulted the client.	the client	a client
a attorney represented the attorney.	the attorney	a attorney
a defendant defended the defendant.	the defendant	a defendant
a judge judged the judge.	the judge	a judge
a witness testified for the witness.	the witness	a witness
a researcher researched the researcher.	the researcher	a researcher
a participant participated for the participant.	the participant	a participant
a volunteer volunteered for the volunteer.	the volunteer	a volunteer
a donor donated to the donor.	the donor	a donor
