a student's guest helped the student.	the student	a student
a artist's collection painted the artist.	the artist	a artist
a chef's project cooked the chef.	the chef	a chef
a dancer's protégé impressed the dancer.	the dancer	a dancer
a writer's client inspired the writer.	the writer	a writer
a athlete's manuscript trained the athlete.	the athlete	a athlete
a musician's photoshoot composed the musician.	the musician	a musician
a doctor's followers treated the doctor.	the doctor	a doctor
a scientist's beat discovered the scientist.	the scientist	a scientist
a driver's team drove the driver.	the driver	a driver
a teacher's space educated the teacher.	the teacher	a teacher
a gardener's portfolio planted the gardener.	the gardener	a gardener
a engineer's client designed the engineer.	the engineer	a engineer
a actor's outfit performed the actor.	the actor	a actor
a photographer's funds captured the photographer.	the photographer	a photographer
a librarian's till organized the librarian.	the librarian	a librarian
a banker's customer invested the banker.	the banker	a banker
a tailor's film sewed the tailor.	the tailor	a tailor
a pilot's peer flew the pilot.	the pilot	a pilot
a lawyer's self-portrait defended the lawyer.	the lawyer	a lawyer
a architect's own designed the architect.	the architect	a architect
a chef's audience cooked the chef.	the chef	a chef
a nurse's readers cared for the nurse.	the nurse	a nurse
a farmer's partner harvested the farmer.	the farmer	a farmer
a plumber's symphony fixed the plumber.	the plumber	a plumber
a cashier's patient counted the cashier.	the cashier	a cashier
a painter's breakthrough painted the painter.	the painter	a painter
a therapist's vehicle counseled the therapist.	the therapist	a therapist
a singer's students sang to the singer.	the singer	a singer
a firefighter's flowers rescued the firefighter.	the firefighter	a firefighter
a fisherman's structure caught the fisherman.	the fisherman	a fisherman
a bartender's role served the bartender.	the bartender	a bartender
a waiter's moment served the waiter.	the waiter	a waiter
a cashier's collection counted the cashier.	the cashier	a cashier
a receptionist's funds greeted the receptionist.	the receptionist	a receptionist
a athlete's garment trained the athlete.	the athlete	a athlete
a journalist's aircraft reported on the journalist.	the journalist	a journalist
a soldier's client fought the soldier.	the soldier	a soldier
a scientist's blueprint researched the scientist.	the scientist	a scientist
a musician's dish played for the musician.	the musician	a musician
a dancer's patient danced for the dancer.	the dancer	a dancer
a explorer's crops discovered the explorer.	the explorer	a explorer
a manager's pipes managed the manager.	the manager	a manager
a coach's money trained the coach.	the coach	a coach
a cleaner's canvas cleaned the cleaner.	the cleaner	a cleaner
a politician's patient campaigned for the politician.	the politician	a politician
a driver's audience drove the driver.	the driver	a driver
a gamer's comrade played against the gamer.	the gamer	a gamer
a analyst's fish analyzed the analyst.	the analyst	a analyst
a CEO's drink led the CEO.	the CEO	a CEO
a receptionist's table greeted the receptionist.	the receptionist	a receptionist
a librarian's change organized the librarian.	the librarian	a librarian
a programmer's visitor coded for the programmer.	the programmer	a programmer
a mentor's teammate mentored the mentor.	the mentor	a mentor
a consultant's story advised the consultant.	the consultant	a consultant
a editor's enemy edited the editor.	the editor	a editor
a model's topic posed for the model.	the model	a model
a influencer's fans influenced the influencer.	the influencer	a influencer
a officer's troupe patrolled the officer.	the officer	a officer
a coach's path coached the coach.	the coach	a coach
a cleaner's team cleaned the cleaner.	the cleaner	a cleaner
a artist's players created for the artist.	the artist	a artist
a designer's space designed for the designer.	the designer	a designer
a stylist's election styled the stylist.	the stylist	a stylist
a banker's route invested the banker.	the banker	a banker
a cashier's opponent counted the cashier.	the cashier	a cashier
a clerk's data assisted the clerk.	the clerk	a clerk
a director's company directed the director.	the director	a director
a producer's show produced for the producer.	the producer	a producer
a writer's publication wrote for the writer.	the writer	a writer
a journalist's story reported on the journalist.	the journalist	a journalist
a critic's review critiqued the critic.	the critic	a critic
a developer's application developed for the developer.	the developer	a developer
a entrepreneur's startup founded the entrepreneur.	the entrepreneur	a entrepreneur
a host's event hosted the host.	the host	a host
a CEO's company led the CEO.	the CEO	a CEO
a manager's department managed the manager.	the manager	a manager
a salesperson's customer sold to the salesperson.	the salesperson	a salesperson
a marketer's campaign marketed for the marketer.	the marketer	a marketer
a intern's supervisor interned for the intern.	the intern	a intern
a analyst's data analyzed the analyst.	the analyst	a analyst
a researcher's topic researched the researcher.	the researcher	a researcher
a scientist's experiment researched the scientist.	the scientist	a scientist
a professor's class taught the professor.	the professor	a professor
a student's subject studied the student.	the student	a student
a doctor's patient treated the doctor.	the doctor	a doctor
a nurse's patient cared for the nurse.	the nurse	a nurse
a therapist's client counseled the therapist.	the therapist	a therapist
a patient's doctor consulted the patient.	the patient	a patient
a therapist's client counseled the therapist.	the therapist	a therapist
a patient's doctor consulted the patient.	the patient	a patient
a client's advisor consulted the client.	the client	a client
a attorney's client represented the attorney.	the attorney	a attorney
a defendant's case defended the defendant.	the defendant	a defendant
a judge's trial judged the judge.	the judge	a judge
a witness's case testified for the witness.	the witness	a witness
a researcher's hypothesis researched the researcher.	the researcher	a researcher
a participant's study participated for the participant.	the participant	a participant
a volunteer's cause volunteered for the volunteer.	the volunteer	a volunteer
a donor's charity donated to the donor.	the donor	a donor
